11111111111111
1K010000000C01
10000111110001
1PC011E0000K01
11111111111111
