1111111111111111111111111111111111
1E0000000000000C00000C000000000001
1010010100100000101001000000010101
1010010011101010001001000000010101
1010010011101010001001000000010101
1010010011101010001001000000010101
1010010011101010001001000000010101
10100100111010100010K1000000010101
101001001110101000100100K000010101
101001K011101010001001000000010101
1010010011101010001001000000010101
1010010011101010001001000000010101
1010010011101010001001000000010101
1010010011101010001001000000010101
1010010011101010001001000000010101
1010010011101010001001000000010101
1010010011101010001001000000010101
1P0000001C00C00000K0000000000000C1
1111111111111111111111111111111111