1111111111111111111111
1010001011101110101111
1010101111111111111011
1000000P00000000001111
10111010111K1C10111011
1111111011101C10CC1011
1000111011101C10111011
10101010111011101CC011
1110111010000010111011
1000C00C101000100000E1
1111111111111111111111